#########1#########2#########3#########4#########5#########6#########7#########8
#
#   nd - Neutron Hodoscope
#
# SHARAQ04 setup:
#  01-20: left forward (north downstream)
#  21-40: left backward (north upstream)
#  41-60: right forward (south downstream)
#  61-80: right backward (south upstream)
#
#  V792(QDC):
#   geo05: 
#    00-02: L01F-L03F
#       03: PS-LF (L04 was broken)
#    04-14: L05F-15F
#       15: blank
#    16-20: L16F-L20F
#       21: blank (dead?)
#    22-23: L02B-L03B
#       24: PS-LB (L04 was broken)
#       25: blank (dead?)
#    26-30: L06B-L10B
#       31: blank
#   geo06:
#       00: blank (dead?)
#    01-03: L12B-L14B
#       04: blank (dead?)
#       05: blank (dead?)
#    06-09: L17B-L20B
#       10: L05B
#       11: L15B
#       12: L01B
#       13: blank (dead?)
#       14: L11B
#       15: L16B
#    16-18: R11B-R13B
#       19: blank (dead?)
#    20-25: R15B-R20B
#       26: R14B
#    27-28: PS-RF,PS-RB
#    29-30: S0PLU,SLPLD
#       31: blank
#   geo07:
#    00-02: R01F-R03F
#       03: blank (ped too high)
#    04-14: R05F-R15F
#       15: R04F
#    16-20: R16F-R20F
#    21-26: R01B-R06B
#       27: blank (dead?)
#    28-30: R08B-R10B
#       31: R07B
# 
#  V1190(TDC):
#   geo10:
#    leading (trailing)
#        000     (128): reference (trig.)
#        001     (129): trigger accept (from upstream DAQ)
#        002     (130): 2-fold coin. (left)
#        003     (131): 2-fold coin. (right)
#    004-015 (132-143): blank
#    016-031 (144-159): blank
#
#    032-034 (160-162): L01F-L03F
#        035     (163): blank
#    036-047 (164-175): L05F-L16F
#
#    048-050 (176-178): L01B-L03B
#        051     (179): blank
#    052-063 (180-191): L05B-L16B
#
#    064-067 (192-195): L17F-L20F
#        068     (196): S0PLU
#        069     (197): S0PLD
#    070-071 (198-199): blank
#    072-075 (200-203): L17B-L20B
#    076-079 (204-207): blank
#
#    080-095 (208-223): R01F-R16F
#
#    096-111 (224-239): R01B-R16B
#
#    112-115 (240-243): R17F-R20F
#        116     (244): PS-RF
#        117     (245): PS-LF
#    118-119 (246-247): blank
#    120-123 (248-251): R17B-R20B
#        124     (252): PS-RB
#        125     (253): PS-LB
#    126-127 (254-255): blank
#
#
# shg01:/home/daq/daqconfig/include/segidlist.h (2012.05.03 now)
#  // Device   0--63
#  define SHARAQ     11
#
#  // Focal plane  0--63
#  /* 20--21, 62 for SHARAQ */
#  // For SHARAQA
#  #define S0  20
#  #define S0S  23
#  #define S0N  24
#
#  // Detector  0--63
#  // For SHARAQ
#  #define SHNWA     40
#  #define SHNWT     41
#
#  // Module  0--255
#  #define V775      21
#  #define V792      21
#  #define V1190     24
#  #define V1190A    24
#  #define V1190B    24
#  #define V1190C    26
#
#
#     | <-------- forward -------------> | <------- backward -----------> |
#   ch,           V792,     V1190(lead)            V792,     V1190(lead) 
# Left (north)                                                            
43   1, 11 20 40  5  0, 11 20 41 10  32,  11 20 40  6 12, 11 20 41 10  48,
43   2, 11 20 40  5  1, 11 20 41 10  33,  11 20 40  5 22, 11 20 41 10  49,
43   3, 11 20 40  5  2, 11 20 41 10  34,  11 20 40  5 23, 11 20 41 10  50,
43   4, 11 20 40  0  0, 11 20 41  0   0,  11 20 40  0  1, 11 20 41  0   1,
43   5, 11 20 40  5  4, 11 20 41 10  36,  11 20 40  6 10, 11 20 41 10  52,
43   6, 11 20 40  5  5, 11 20 41 10  37,  11 20 40  5 26, 11 20 41 10  53,
43   7, 11 20 40  5  6, 11 20 41 10  38,  11 20 40  5 27, 11 20 41 10  54,
43   8, 11 20 40  5  7, 11 20 41 10  39,  11 20 40  5 28, 11 20 41 10  55,
43   9, 11 20 40  5  8, 11 20 41 10  40,  11 20 40  5 29, 11 20 41 10  56,
43  10, 11 20 40  5  9, 11 20 41 10  41,  11 20 40  5 30, 11 20 41 10  57,
43  11, 11 20 40  5 10, 11 20 41 10  42,  11 20 40  6 14, 11 20 41 10  58,
43  12, 11 20 40  5 11, 11 20 41 10  43,  11 20 40  6  1, 11 20 41 10  59,
43  13, 11 20 40  5 12, 11 20 41 10  44,  11 20 40  6  2, 11 20 41 10  60,
43  14, 11 20 40  5 13, 11 20 41 10  45,  11 20 40  6  3, 11 20 41 10  61,
43  15, 11 20 40  5 14, 11 20 41 10  46,  11 20 40  6 11, 11 20 41 10  62,
43  16, 11 20 40  5 16, 11 20 41 10  47,  11 20 40  6 15, 11 20 41 10  63,
43  17, 11 20 40  5 17, 11 20 41 10  64,  11 20 40  6  6, 11 20 41 10  72,
43  18, 11 20 40  5 18, 11 20 41 10  65,  11 20 40  6  7, 11 20 41 10  73,
43  19, 11 20 40  5 19, 11 20 41 10  66,  11 20 40  6  8, 11 20 41 10  74,
43  20, 11 20 40  5 20, 11 20 41 10  67,  11 20 40  6  9, 11 20 41 10  75,
# Right (south)
43  21, 11 20 40  7  0, 11 20 41 10  80,  11 20 40  7 21, 11 20 41 10  96,
43  22, 11 20 40  7  1, 11 20 41 10  81,  11 20 40  7 22, 11 20 41 10  97,  
43  23, 11 20 40  7  2, 11 20 41 10  82,  11 20 40  7 23, 11 20 41 10  98,  
43  24, 11 20 40  7 15, 11 20 41 10  83,  11 20 40  7 24, 11 20 41 10  99,  
43  25, 11 20 40  7  4, 11 20 41 10  84,  11 20 40  7 25, 11 20 41 10 100,  
43  26, 11 20 40  7  5, 11 20 41 10  85,  11 20 40  7 26, 11 20 41 10 101,  
43  27, 11 20 40  7  6, 11 20 41 10  86,  11 20 40  7 31, 11 20 41 10 102,  
43  28, 11 20 40  7  7, 11 20 41 10  87,  11 20 40  7 28, 11 20 41 10 103,  
43  29, 11 20 40  7  8, 11 20 41 10  88,  11 20 40  7 29, 11 20 41 10 104,  
43  30, 11 20 40  7  9, 11 20 41 10  89,  11 20 40  7 30, 11 20 41 10 105,  
43  31, 11 20 40  7 10, 11 20 41 10  90,  11 20 40  6 16, 11 20 41 10 106,  
43  32, 11 20 40  7 11, 11 20 41 10  91,  11 20 40  6 17, 11 20 41 10 107,  
43  33, 11 20 40  7 12, 11 20 41 10  92,  11 20 40  6 18, 11 20 41 10 108,  
43  34, 11 20 40  7 13, 11 20 41 10  93,  11 20 40  6 26, 11 20 41 10 109,  
43  35, 11 20 40  7 14, 11 20 41 10  94,  11 20 40  6 20, 11 20 41 10 110,  
43  36, 11 20 40  7 16, 11 20 41 10  95,  11 20 40  6 21, 11 20 41 10 111,  
43  37, 11 20 40  7 17, 11 20 41 10 112,  11 20 40  6 22, 11 20 41 10 120,  
43  38, 11 20 40  7 18, 11 20 41 10 113,  11 20 40  6 23, 11 20 41 10 121,  
43  39, 11 20 40  7 19, 11 20 41 10 114,  11 20 40  6 24, 11 20 41 10 122,  
43  40, 11 20 40  7 20, 11 20 41 10 115,  11 20 40  6 25, 11 20 41 10 123,  


