41,  0, 11,20,31,3,  0 
41,  1, 11,20,31,3,  1 
41,  2, 11,20,31,3,  2 
41,  3, 11,20,31,3,  3 
41,  4, 11,20,31,3,  4 
41,  5, 11,20,31,3,  5 
41,  6, 11,20,31,3,  6 
41,  7, 11,20,31,3,  7 
41,  8, 11,20,31,3,  8 
41,  9, 11,20,31,3,  9 
41, 10, 11,20,31,3, 10 
41, 11, 11,20,31,3, 11 
41, 12, 11,20,31,3, 12 
41, 13, 11,20,31,3, 13 
41, 14, 11,20,31,3, 14 
41, 15, 11,20,31,3, 15 
41, 16, 11,20,31,3, 16 
41, 17, 11,20,31,3, 17 
41, 18, 11,20,31,3, 18 
41, 19, 11,20,31,3, 19 
41, 20, 11,20,31,3, 20 
41, 21, 11,20,31,3, 21 
41, 22, 11,20,31,3, 22 
41, 23, 11,20,31,3, 23 
41, 24, 11,20,31,3, 24 
41, 25, 11,20,31,3, 25 
41, 26, 11,20,31,3, 26 
41, 27, 11,20,31,3, 27 
41, 28, 11,20,31,3, 28 
41, 29, 11,20,31,3, 29 
41, 30, 11,20,31,3, 30 
41, 31, 11,20,31,3, 31 
41, 32, 11,20,31,3, 32 
41, 33, 11,20,31,3, 33 
41, 34, 11,20,31,3, 34 
41, 35, 11,20,31,3, 35 
41, 36, 11,20,31,3, 36 
41, 37, 11,20,31,3, 37 
41, 38, 11,20,31,3, 38 
41, 39, 11,20,31,3, 39 
41, 40, 11,20,31,3, 64 
41, 41, 11,20,31,3, 65 
41, 42, 11,20,31,3, 66 
41, 43, 11,20,31,3, 67 
41, 44, 11,20,31,3, 68 
41, 45, 11,20,31,3, 69 
41, 46, 11,20,31,3, 70 
41, 47, 11,20,31,3, 71 
41, 48, 11,20,31,3, 72 
41, 49, 11,20,31,3, 73 
41, 50, 11,20,31,3, 74 
41, 51, 11,20,31,3, 75 
41, 52, 11,20,31,3, 76 
41, 53, 11,20,31,3, 77 
41, 54, 11,20,31,3, 78 
41, 55, 11,20,31,3, 79 
41, 56, 11,20,31,3, 80 
41, 57, 11,20,31,3, 81 
41, 58, 11,20,31,3, 82 
41, 59, 11,20,31,3, 83 
41, 60, 11,20,31,3, 84 
41, 61, 11,20,31,3, 85 
41, 62, 11,20,31,3, 86 
41, 63, 11,20,31,3, 87 
41, 64, 11,20,31,3, 88 
41, 65, 11,20,31,3, 89 
41, 66, 11,20,31,3, 90 
41, 67, 11,20,31,3, 91 
41, 68, 11,20,31,3, 92 
41, 69, 11,20,31,3, 93 
41, 70, 11,20,31,3, 94 
41, 71, 11,20,31,3, 95 
41, 72, 11,20,31,3, 96 
41, 73, 11,20,31,3, 97 
41, 74, 11,20,31,3, 98 
41, 75, 11,20,31,3, 99 
41, 76, 11,20,31,3,100 
41, 77, 11,20,31,3,101 
41, 78, 11,20,31,3,102 
41, 79, 11,20,31,3,103 
41, 80, 11,20,31,3, 40 
41, 81, 11,20,31,3, 41 
41, 82, 11,20,31,3, 42 
41, 83, 11,20,31,3, 43 
41, 84, 11,20,31,3, 44 
41, 85, 11,20,31,3, 45 
41, 86, 11,20,31,3, 46 
41, 87, 11,20,31,3, 47 
41, 88, 11,20,31,3, 48 
41, 89, 11,20,31,3, 49 
41, 90, 11,20,31,3, 50 
41, 91, 11,20,31,3, 51 
41, 92, 11,20,31,3, 52 
41, 93, 11,20,31,3, 53 
41, 94, 11,20,31,3, 54 
41, 95, 11,20,31,3, 55 
41, 96, 11,20,31,3, 56 
41, 97, 11,20,31,3, 57 
41, 98, 11,20,31,3, 58 
41, 99, 11,20,31,3, 59 
41,100, 11,20,31,3,104 
41,101, 11,20,31,3,105 
41,102, 11,20,31,3,106 
41,103, 11,20,31,3,107 
41,104, 11,20,31,3,108 
41,105, 11,20,31,3,109 
41,106, 11,20,31,3,110 
41,107, 11,20,31,3,111 
41,108, 11,20,31,3,112 
41,109, 11,20,31,3,113 
41,110, 11,20,31,3,114 
41,111, 11,20,31,3,115 
41,112, 11,20,31,3,116 
41,113, 11,20,31,3,117 
41,114, 11,20,31,3,118 
41,115, 11,20,31,3,119 
41,116, 11,20,31,3,120 
41,117, 11,20,31,3,121 
41,118, 11,20,31,3,122 
41,119, 11,20,31,3,123 